ventanaError-titulo=Error
resourceBundle-titulo=Editar resource bundle
resourceBundle-contexto=Contexto
resourceBundle-clave=Clave
resourceBundle-traduccion=Traducción
resourceBundle-buscar=Buscar
resourceBundle-errorGrabar=El resource bundle no ha podido ser salvado.
resetPassword-titulo=Usuarios
resetPassword-usuario=Usuario
resetPassword-nombre=Nombre
resetPassword-email=E-Mail
resetPassword-delegacion=Delegación
resetPassword-solicitoBlanqueo=Solicitó blanqueo
resetPassword-claveProvisoria=Clave Provisoria
resetPassword-si=SI
resetPassword-no=NO
resetPassword-confirmarBlanqueo=Desea blanquear las contraseñas a los usuarios seleccionados?
resetPassword-seleccionarTodos=Seleccionar todos
resetPassword-blanquear=Blanquear contraseñas
requestPassword-titulo=Blanqueo de Contraseña
requestPassword-ayuda=En caso de no recordar su contrase&ntilde;a, le sugerimos pedir un blanqu&eacute;o de la misma, completando su usuario, la direcci&oacute;n de E-Mail utilizada para su registraci&oacute;n y haciendo clic  en el bot&oacute;n &ldquo;solicitar contrase&ntilde;a&rdquo;.
requestPassword-usuario=Usuario
requestPassword-email=E-mail
requestPassword-solicitar=Solicitar Contraseña
referenceDocumentLibrary-titulo=Documentos Informativos
referenceDocumentLibrary-categoria=Categoría
referenceDocumentLibrary-archivo=Archivo
referenceDocumentLibrary-tituloDocumento=Título
referenceDocumentABM-titulo=Editar categorías para Documentos Informativos
referenceDocumentABM-tituloDocumento=Titulo
referenceDocumentABM-elegirArchivo=Elegir archivo
referenceDocumentABM-categoria=Categoría
referenceDocumentABM-crear=Crear Documento
referenceDocumentABM-modificar=Modificar
referenceDocumentABM-cancelar=Cancelar
referenceDocumentABM-archivo=Archivo
referenceDocumentABM-tituloListado=Listado de archivos de Documentos Informativos
searchObservations-titulo=Buscar observaciones
searchObservations-delegacion=Delegación
searchObservations-todos=Todos
searchObservations-fechaExacta=Buscar por fecha exacta
searchObservations-rangoFechas=Buscar por rango de fechas
searchObservations-desde=Desde
searchObservations-hasta=Hasta
searchObservations-parrafo=Párrafo
searchObservations-palabras=Palabras
searchObservations-buscar=Buscaradministrador
searchObservations-volver=Volver
signatureShow-titulo=Documento
signatureShow-numeroVersion=Número de Versión
signatureShow-nombre=Nombre
signatureShow-por=Por
sysProperty-titulo=Editar property
sysProperty-clave=Clave
sysProperty-valor=Valor
sysProperty-modificar=Modificar
systemUserABM-titulo=Editar usuarios del sistema
systemUserABM-apellidoNombre=Apellido y Nombre
systemUserABM-nombreUsuario=Nombre de Usuario
systemUserABM-email=E-Mail
systemUserABM-administrador=Administrador
systemUserABM-secretaria=Secretaría
systemUserABM-diseñador=Diseñador
systemUserABM-asistente=Asistente
systemUserABM-traductor=Traductor
systemUserABM-crear=Crear
systemUserABM-modificar=Modificar
systemUserABM-cancelar=Cancelar
systemUserABM-nombre=Nombre
systemUserABM-permisos=Permisos
systemUserABM-habilitado=Habilitado
systemUserABM-no=NO
systemUserABM-si=SI
systemUserABM-tituloListado=Listado de usuarios del sistema